1111111111111
1002000C00001
1001000C00001
1000000000001
10C1200000201
10100C1002101
1201000C0P001
10000110100E1
1111111111111
